.,.,.,W,F
.,.,.,W,F
M,M,R,M,M
#,#,.,F,F
#,#,.,F,F